ARTIST - TITLE
Apollo 440 - Stop the Rock
Audio Bullys - Way Too Long
Bacilos - Caraluna
Bacilos - Mi Primer Millon
Barthezz - On the move
Black & Jones - Cream
Black - Wonderful Life
Cabas - Increible
Chicane - No Ordinary Morning
Clannad - Darkmere
Compay Segundo - Chan Chan
Cusco - Tigris & Euphrates
Deep Dish - Floating
Edouard Nenez et les princes de Bretagne - Ouest France 2000
Edouard Nenez et les princes de Bretagne - Princes de Bretagne
Ekhymosis - Escuchas Crecer una Flor
El Gran Silencio - Dormir Sonhando
Estopa - Luna lunera
Fabulosos Cadillac
Faithless - God is a DJ
Faithless - Salva Mea
Floating - Deep Dish
Frank Delgado - Boleros De Victrola
Freshlyground - Father Please
Gilbert B¨¦caud - Nathalie
Gouryella - Tenshi
Groove Amanda - At the River
Groove Armada - Inside My Mind (Blue Skies)
Guadalupe Pineda - Jacinto Cenobio
Gustavo Cerati
Henry McClintock - Big Rock Candy Mountain
Herbert Groenemeyer
Hyper - Cascade
Ibrahim Ferrer - Candela
Inal Bilsel - Cradle for Life
Inti Illimani - Lo que mas quiero
Jarabe de Palo - De Vuelta Y Vuelta
Javier Krahe - Marieta
Jean Ferrat
Julien Clerc - Ce N'est Rien
Lajko Felix (http://www.lajkofelix.hu/english/index.php)
Leftfield - Phat planet
Manic Street Preachers
Marius Muller_Westerhagen
Massive Attack - Teardrop
Michel Fugain
Mike Oldfield - In Dulci Jubilo
New Order - Temptation
Nina Hagen
Norman Blake - I am a man of constant sorrow
Oasis
Pablo Milanes
Poligamia - Mi Generacion
Pyotr Ilyich Tchaikovsky - Dance Of The Mirlitons
Royksopp - Eple
Riding the fourth wave - Catch 22
Robert Miles - Fable
Sash! - Multiple Teaser
Scooter - How much is the fish
Serge Lama - Je suis malade
Serge Reggiani - Compagnons Des Mauvais Jours
Sergio Dalma
Soda Stereo
The Chemical Brothers - Galvanize
The Corrs - Dreams
The Prodigy - Diesel Power
The Sabres of Paradise - The Sabres of Paradise
The Soggy Bottom Boys - I am a man of constant sorrow
The Verve
Underworld - Pearls Field
Vinicius de Moraes - Samba de bencao
Voodoo Child - Take it Home
WIZO - Quadrat im Kreis
Willie Colon/Hector Lavoe - Aguanile
Yanni - The Rain Must Fall
